NO assets/wall_north.xpm
SO assets/wall_south.xpm
WE assets/wall_west.xpm
EA assets/wall_east.xpm

C 220,100,0
F 225,30,0

        1111111111111111111111111
        1000000000110000000000001
        1011000001110000000000001
        100D000000000000000000001
111111111011000001110000000000001
1000000000110000011101D1111111111
11110111111111011100000010001
11110111111111011101000100001
1100W000110101011100000010001
100000000000000011000000D0001
10000000000000001101010010001
1100000111010101111101111000111
11110111 1110101 101111010001
11111111 1111111 111111111111
